00000000000000000000
00000000000000000001
00000000000000000004
00000000000000000004
30000000000000000004
60000000000000000004
60000000000000000004
60000000000000000004
60000000000000001225
60000000000000007885
60000000000000000004
60000001222230000004
60000004555560000004
60000004555552222225
52222225555555555555